2
00 00 00 00 00 00 00 00 00 00
00 00 00 00 00 00 00 00 00 00
00 00 00 04 04 04 04 00 00 00
00 00 00 03 03 03 03 00 00 00
00 00 00 06 01 01 06 00 00 00
00 00 00 06 06 06 06 00 00 00
00 00 00 00 00 00 00 00 00 00