3
01 05 01 05 01 05 01 05 01 05
05 01 05 01 05 01 05 01 05 01
01 05 01 05 01 05 01 05 01 05
05 01 05 01 05 01 05 01 05 01
03 05 03 05 03 05 03 05 03 05
05 01 05 01 05 01 05 01 05 01
01 01 01 02 03 03 02 01 01 01