5
00 00 00 01 01 01 01 00 00 00
00 00 01 01 01 01 01 01 00 00
00 01 03 03 01 01 03 03 01 00
00 01 01 01 01 01 01 01 01 00
00 01 01 01 01 01 01 01 01 00
00 00 01 02 02 02 02 01 00 00
00 00 00 01 01 01 01 00 00 00