4
01 03 01 00 00 00 00 01 03 01
02 05 02 01 05 05 01 02 05 02
01 03 01 00 00 00 00 01 03 01
02 02 02 02 04 04 04 01 01 01
01 01 01 02 02 02 02 01 01 01
01 01 01 01 01 01 01 01 01 01
02 02 02 04 04 04 01 01 01 01