8
02 02 02 00 00 00 00 00 00 00
03 03 03 03 00 00 00 00 00 00
05 05 02 02 02 02 00 00 00 00
05 05 05 01 01 01 01 00 00 00
05 05 05 05 03 03 03 03 00 00
02 02 02 02 02 02 02 02 02 00
04 04 04 04 04 04 06 06 06 06